--------------------
--------------------
--------------------
---000000--000000---
---0------------0---
---0------------0---
---0------------0---
---0------------0---
---0------------0---
---0-----11-----0---
---0-----11-----0---
---0------------0---
---0------------0---
---0------------0---
---0------------0---
---0------------0---
---00000000000000---
--------------------
--------------------
--------------------