--------------------
-111111111111111111-
--------------------
-111111111111111111-
--------------------
-111111111111111111-
--------------------
-111111111111111111-
--------------------
-111111111111111111-
--------------------
--11111------11111--
--11111------11111--
--11111------11111--
--5555555555555555--
--------------------
--------------------
--------------------
--------------------
--------------------