--------------------
-111111111111111111-
--------------------
-111111111111111111-
--------------------
-111111111111111111-
--------------------
-111111111111111111-
--------------------
-111111111111111111-
--------------------
--11111------11111--
--11111------11111--
--1111155555511111--
--0000000000000000--
--------------------
--------------------
--------------------
--------------------
--------------------