--------------------
-111111111111111111-
--------------------
-111111111111111111-
--------------------
-111111111111111111-
--------------------
-111111111111111111-
--------------------
-222222222222222222-
--------------------
--11111------11111--
--11111------11111--
--1111111111111111--
---00000000000000---
--------------------
--------------------
--------------------
--------------------
--------------------