--------------------
-11--------------11-
-111111111111111111-
--1444444444444441--
--1111111111111111--
--11111------11111--
----111------111----
11111----------11111
---11122222222111---
-----1111111111-----
--------------------
--11111------11111--
--33333------33333--
--11111------11111--
--55555------55555--
--------------------
--------------------
--------------------
--------------------
--------------------