--------------------
--------------------
11111111122111111111
11111111222211111111
11111111122111111111
--------------------
--------------------
--------------------
--------------------
--------------------
--------------------
--------------------
--------------------
--------------------
--------------------
--------------------
--------------------
--------------------
--------------------
--------------------