--------------------
--------------------
-------111111-------
-----1111111111-----
----111111111111----
---11111111111111---
---11110011111111---
--11111001111111----
--111111111111------
--1111111111--------
--1111111111--------
--111111111111------
--11111111111111----
---11111111111111---
---11111111111111---
----111111111111----
-----1111111111-----
-------111111-------
--------------------
--------------------