--------------------
--------------------
--------------------
---33333333333333---
---3------------3---
---3-2222222222-3---
---3-2--------2-3---
---3-2-111111-2-3---
---3-2-1----1-2-3---
---3-2-1-11-1-2-3---
---3-2-1-1--1-2-3---
---3-2-1-1111-2-3---
---3-2-1------2-3---
---3-2-22222222-3---
---3-2----------3---
---3-333333333333---
--------------------
--------------------
--------------------
--------------------